energy, EnrBEGe, EnrCoax, EnrCoax_2, EnrInvCoax, EnrBEGe_2, EnrAll
0, 0, 0, 0, 0, 0, 0
5, 10, 0, 0, 26272, 66, 26348
10, 2675, 0, 0, 112107, 7867, 122649
15, 30867, 0, 0, 68470, 86160, 185497
20, 36227, 3, 0, 36230, 101015, 173475
25, 21899, 86, 0, 20021, 56058, 98064
30, 13149, 1419, 11, 12070, 32328, 58977
35, 8426, 2742, 166, 8227, 21001, 40562
40, 6610, 2434, 885, 6915, 16466, 33310
45, 6151, 2411, 2144, 6932, 15355, 32993
50, 6285, 2461, 3257, 7507, 16106, 35616
55, 7242, 2831, 4299, 8678, 18401, 41451
60, 8844, 3231, 5212, 9833, 21995, 49115
65, 10380, 3834, 6436, 10876, 26969, 58495
70, 12096, 4568, 7747, 11672, 31653, 67736
75, 13574, 5103, 9070, 12470, 35330, 75547
80, 14597, 5786, 9800, 12912, 38145, 81240
85, 15406, 6126, 10471, 13192, 40173, 85368
90, 15426, 6369, 11009, 13054, 40907, 86765
95, 15431, 6575, 10857, 12342, 40783, 85988
100, 15404, 6534, 10993, 12188, 40202, 85321
105, 14483, 6129, 10840, 11518, 38676, 81646
110, 13883, 5924, 10146, 10762, 36353, 77068
115, 12874, 5789, 9588, 10333, 34083, 72667
120, 12115, 5478, 9219, 9492, 31661, 67965
125, 10872, 5141, 8553, 8624, 29030, 62220
130, 10026, 4786, 8089, 7904, 27048, 57853
135, 9107, 4448, 7511, 7363, 24412, 52841
140, 9272, 4206, 6985, 6841, 22006, 49310
145, 14237, 4501, 6465, 6023, 19722, 50948
150, 20803, 5689, 5814, 5440, 18093, 55839
155, 21311, 5688, 5484, 4892, 15911, 53286
160, 20416, 5609, 4956, 4464, 14482, 49927
165, 18915, 5547, 4569, 4147, 12617, 45795
170, 16637, 5638, 4153, 3662, 11768, 41858
175, 15209, 6384, 3733, 3294, 10114, 38734
180, 13581, 6783, 3486, 3001, 9135, 35986
185, 12194, 6774, 3179, 2537, 8092, 32776
190, 10964, 6754, 2817, 2312, 7373, 30220
195, 9673, 6153, 2691, 2084, 6486, 27087
200, 8803, 5794, 2465, 1876, 5873, 24811
205, 7651, 5325, 2342, 1720, 5013, 22051
210, 6973, 4925, 2116, 1558, 4568, 20140
215, 6460, 4625, 1899, 1384, 4042, 18410
220, 5629, 4190, 1771, 1234, 3776, 16600
225, 5054, 4038, 1580, 1176, 3364, 15212
230, 4596, 3572, 1528, 1059, 2931, 13686
235, 4428, 3449, 1462, 1006, 2861, 13206
240, 3787, 3182, 1331, 888, 2477, 11665
245, 3417, 2973, 1150, 724, 2140, 10404
250, 3121, 2605, 1048, 702, 1950, 9426
255, 2803, 2501, 1026, 649, 1760, 8739
260, 2595, 2316, 981, 572, 1558, 8022
265, 2411, 2249, 871, 536, 1468, 7535
270, 2065, 2063, 850, 484, 1324, 6786
275, 1897, 1979, 813, 429, 1203, 6321
280, 1737, 1713, 656, 395, 1125, 5626
285, 1561, 1660, 692, 359, 1007, 5279
290, 1474, 1560, 643, 406, 905, 4988
295, 1426, 1539, 576, 344, 890, 4775
300, 1248, 1382, 498, 270, 751, 4149
305, 1237, 1290, 493, 278, 733, 4031
310, 1106, 1187, 454, 240, 662, 3649
315, 1081, 1164, 420, 258, 623, 3546
320, 971, 1009, 392, 228, 600, 3200
325, 950, 1025, 352, 189, 548, 3064
330, 817, 940, 329, 161, 493, 2740
335, 807, 880, 323, 197, 517, 2724
340, 724, 870, 334, 185, 453, 2566
345, 674, 866, 308, 182, 455, 2485
350, 788, 836, 341, 190, 468, 2623
355, 678, 678, 278, 155, 386, 2175
360, 644, 669, 271, 159, 385, 2128
365, 582, 656, 251, 142, 335, 1966
370, 576, 596, 266, 131, 342, 1911
375, 532, 614, 191, 138, 348, 1823
380, 509, 594, 187, 137, 332, 1759
385, 499, 584, 184, 125, 285, 1677
390, 462, 529, 194, 137, 318, 1640
395, 478, 511, 162, 127, 294, 1572
400, 460, 483, 165, 124, 284, 1516
405, 453, 442, 163, 123, 264, 1445
410, 458, 453, 184, 106, 308, 1509
415, 443, 457, 175, 114, 292, 1481
420, 451, 414, 155, 135, 273, 1428
425, 423, 383, 131, 106, 250, 1293
430, 436, 400, 138, 118, 270, 1362
435, 403, 361, 151, 107, 294, 1316
440, 374, 376, 135, 117, 276, 1278
445, 428, 336, 141, 101, 267, 1273
450, 398, 384, 137, 111, 285, 1315
455, 380, 330, 116, 114, 285, 1225
460, 417, 351, 116, 95, 257, 1236
465, 398, 337, 132, 117, 270, 1254
470, 381, 325, 141, 99, 255, 1201
475, 416, 314, 114, 102, 272, 1218
480, 410, 309, 147, 101, 251, 1218
485, 371, 278, 120, 104, 283, 1156
490, 396, 277, 125, 118, 265, 1181
495, 366, 306, 139, 99, 266, 1176
500, 402, 281, 108, 118, 244, 1153
505, 396, 318, 127, 109, 268, 1218
510, 459, 376, 165, 153, 285, 1438
515, 373, 295, 136, 105, 269, 1178
520, 390, 292, 134, 107, 237, 1160
525, 396, 258, 107, 114, 257, 1132
530, 379, 268, 126, 143, 263, 1179
535, 379, 324, 105, 96, 247, 1151
540, 391, 257, 123, 124, 251, 1146
545, 386, 288, 109, 106, 265, 1154
550, 376, 264, 125, 121, 258, 1144
555, 421, 284, 113, 114, 248, 1180
560, 363, 296, 103, 114, 233, 1109
565, 438, 287, 104, 112, 221, 1162
570, 360, 297, 140, 95, 278, 1170
575, 359, 265, 137, 111, 271, 1143
580, 422, 305, 147, 116, 272, 1262
585, 412, 288, 123, 128, 267, 1218
590, 398, 257, 120, 104, 256, 1135
595, 375, 265, 115, 112, 270, 1137
600, 430, 267, 115, 126, 294, 1232
605, 432, 327, 119, 113, 319, 1310
610, 396, 280, 114, 131, 277, 1198
615, 396, 286, 148, 97, 247, 1174
620, 390, 262, 124, 114, 250, 1140
625, 385, 273, 131, 110, 256, 1155
630, 372, 271, 133, 110, 284, 1170
635, 429, 265, 126, 121, 262, 1203
640, 425, 281, 125, 119, 242, 1192
645, 400, 267, 120, 111, 259, 1157
650, 426, 303, 115, 112, 275, 1231
655, 371, 330, 134, 94, 263, 1192
660, 388, 294, 136, 119, 298, 1235
665, 392, 274, 141, 108, 240, 1155
670, 386, 307, 106, 135, 274, 1208
675, 417, 283, 120, 108, 280, 1208
680, 382, 286, 115, 110, 271, 1164
685, 391, 262, 104, 104, 268, 1129
690, 377, 296, 123, 120, 258, 1174
695, 403, 266, 123, 123, 270, 1185
700, 378, 286, 132, 111, 274, 1181
705, 365, 283, 117, 136, 280, 1181
710, 404, 300, 124, 116, 268, 1212
715, 380, 310, 125, 119, 244, 1178
720, 398, 306, 103, 124, 277, 1208
725, 401, 297, 126, 113, 268, 1205
730, 379, 268, 120, 101, 268, 1136
735, 369, 285, 119, 117, 257, 1147
740, 379, 281, 117, 102, 256, 1135
745, 364, 308, 108, 106, 250, 1136
750, 366, 296, 129, 98, 247, 1136
755, 337, 245, 99, 100, 253, 1034
760, 360, 263, 122, 107, 239, 1091
765, 392, 279, 118, 109, 243, 1141
770, 370, 282, 142, 98, 255, 1147
775, 345, 282, 129, 111, 258, 1125
780, 382, 277, 128, 119, 257, 1163
785, 349, 281, 118, 99, 273, 1120
790, 348, 251, 127, 95, 243, 1064
795, 351, 273, 115, 116, 250, 1105
800, 362, 291, 123, 97, 231, 1104
805, 360, 236, 105, 111, 225, 1037
810, 334, 260, 125, 129, 220, 1068
815, 362, 271, 115, 98, 268, 1114
820, 359, 259, 97, 112, 235, 1062
825, 326, 292, 122, 127, 231, 1098
830, 357, 256, 117, 91, 238, 1059
835, 391, 276, 116, 93, 211, 1087
840, 365, 271, 120, 107, 243, 1106
845, 360, 268, 133, 112, 231, 1104
850, 335, 231, 124, 102, 240, 1032
855, 361, 265, 101, 106, 228, 1061
860, 336, 291, 108, 104, 222, 1061
865, 364, 268, 128, 102, 214, 1076
870, 322, 261, 107, 107, 218, 1015
875, 343, 287, 121, 99, 238, 1088
880, 345, 255, 101, 87, 230, 1018
885, 332, 255, 111, 102, 229, 1029
890, 335, 240, 115, 87, 231, 1008
895, 325, 237, 92, 108, 231, 993
900, 319, 265, 89, 118, 226, 1017
905, 332, 255, 104, 100, 229, 1020
910, 339, 239, 109, 94, 228, 1009
915, 341, 246, 107, 100, 219, 1013
920, 324, 236, 102, 103, 206, 971
925, 309, 252, 131, 91, 179, 962
930, 293, 227, 125, 84, 236, 965
935, 275, 230, 99, 70, 218, 892
940, 300, 232, 99, 91, 195, 917
945, 362, 232, 103, 92, 216, 1005
950, 297, 251, 95, 82, 206, 931
955, 295, 224, 101, 88, 221, 929
960, 262, 238, 114, 84, 230, 928
965, 303, 236, 99, 106, 188, 932
970, 276, 221, 105, 96, 200, 898
975, 319, 230, 110, 84, 175, 918
980, 271, 230, 118, 75, 186, 880
985, 265, 241, 96, 94, 205, 901
990, 288, 209, 87, 87, 169, 840
995, 273, 218, 94, 83, 194, 862
1000, 315, 232, 98, 86, 195, 926
1005, 289, 205, 95, 71, 165, 825
1010, 267, 208, 95, 77, 189, 836
1015, 295, 226, 106, 78, 164, 869
1020, 276, 218, 82, 77, 174, 827
1025, 276, 188, 86, 83, 180, 813
1030, 240, 190, 85, 79, 181, 775
1035, 275, 187, 77, 72, 183, 794
1040, 239, 208, 104, 77, 192, 820
1045, 254, 189, 94, 70, 169, 776
1050, 266, 186, 79, 70, 165, 766
1055, 226, 207, 107, 71, 168, 779
1060, 245, 193, 89, 83, 166, 776
1065, 297, 186, 93, 59, 186, 821
1070, 242, 198, 80, 71, 157, 748
1075, 223, 222, 91, 73, 188, 797
1080, 241, 212, 89, 72, 170, 784
1085, 255, 181, 75, 61, 150, 722
1090, 254, 175, 86, 62, 170, 747
1095, 259, 178, 73, 62, 164, 736
1100, 244, 180, 82, 73, 152, 731
1105, 257, 186, 84, 65, 149, 741
1110, 214, 201, 69, 66, 153, 703
1115, 200, 187, 81, 94, 159, 721
1120, 225, 204, 65, 82, 147, 723
1125, 209, 185, 69, 58, 171, 692
1130, 214, 162, 68, 66, 176, 686
1135, 237, 134, 73, 54, 161, 659
1140, 215, 160, 60, 58, 148, 641
1145, 223, 154, 65, 60, 152, 654
1150, 220, 160, 72, 63, 143, 658
1155, 216, 165, 67, 59, 141, 648
1160, 177, 164, 83, 67, 133, 624
1165, 196, 168, 66, 68, 139, 637
1170, 222, 206, 71, 57, 143, 699
1175, 188, 152, 73, 64, 137, 614
1180, 210, 151, 64, 81, 137, 643
1185, 228, 130, 84, 38, 138, 618
1190, 192, 193, 66, 72, 130, 653
1195, 187, 151, 54, 49, 137, 578
1200, 233, 145, 64, 67, 130, 639
1205, 206, 131, 77, 51, 122, 587
1210, 189, 153, 83, 56, 113, 594
1215, 196, 152, 61, 49, 120, 578
1220, 189, 180, 79, 46, 128, 622
1225, 175, 127, 61, 48, 132, 543
1230, 208, 148, 64, 56, 120, 596
1235, 207, 148, 64, 55, 119, 593
1240, 188, 127, 66, 52, 109, 542
1245, 171, 136, 61, 46, 112, 526
1250, 161, 150, 65, 47, 120, 543
1255, 155, 145, 71, 50, 83, 504
1260, 186, 129, 64, 39, 93, 511
1265, 162, 120, 61, 38, 96, 477
1270, 153, 132, 55, 31, 90, 461
1275, 150, 131, 57, 46, 102, 486
1280, 150, 128, 56, 38, 113, 485
1285, 137, 165, 62, 46, 106, 516
1290, 150, 143, 61, 43, 99, 496
1295, 178, 149, 51, 37, 108, 523
1300, 121, 138, 54, 38, 99, 450
1305, 128, 114, 51, 38, 81, 412
1310, 116, 115, 37, 34, 60, 362
1315, 101, 101, 52, 35, 67, 356
1320, 118, 92, 53, 26, 85, 374
1325, 117, 89, 47, 26, 71, 350
1330, 106, 118, 48, 27, 81, 380
1335, 99, 106, 46, 36, 64, 351
1340, 96, 100, 50, 31, 53, 330
1345, 96, 97, 42, 21, 62, 318
1350, 83, 75, 38, 25, 53, 274
1355, 78, 85, 29, 27, 53, 272
1360, 81, 77, 30, 17, 62, 267
1365, 72, 81, 35, 29, 57, 274
1370, 79, 72, 33, 29, 50, 263
1375, 73, 65, 24, 31, 63, 256
1380, 79, 89, 28, 21, 39, 256
1385, 61, 59, 32, 15, 46, 213
1390, 62, 80, 30, 22, 29, 223
1395, 67, 64, 26, 21, 35, 213
1400, 59, 57, 31, 23, 45, 215
1405, 71, 79, 35, 17, 41, 243
1410, 53, 52, 27, 17, 26, 175
1415, 47, 62, 32, 21, 38, 200
1420, 48, 60, 25, 15, 32, 180
1425, 48, 60, 21, 18, 37, 184
1430, 53, 50, 24, 16, 36, 179
1435, 49, 39, 20, 24, 31, 163
1440, 52, 58, 21, 12, 34, 177
1445, 45, 44, 22, 15, 26, 152
1450, 37, 45, 17, 15, 21, 135
1455, 87, 184, 86, 37, 58, 452
1460, 254, 455, 169, 100, 138, 1116
1465, 35, 44, 24, 13, 26, 142
1470, 36, 46, 12, 9, 30, 133
1475, 39, 33, 13, 13, 30, 128
1480, 40, 24, 20, 10, 26, 120
1485, 31, 32, 11, 7, 25, 106
1490, 26, 32, 15, 11, 28, 112
1495, 26, 27, 11, 7, 10, 81
1500, 29, 40, 13, 9, 21, 112
1505, 22, 35, 11, 5, 22, 95
1510, 33, 29, 14, 10, 15, 101
1515, 34, 37, 34, 8, 27, 140
1520, 232, 625, 227, 61, 130, 1275
1525, 192, 492, 181, 63, 103, 1031
1530, 26, 19, 10, 9, 16, 80
1535, 25, 14, 10, 15, 18, 82
1540, 27, 23, 10, 7, 15, 82
1545, 19, 19, 6, 5, 12, 61
1550, 16, 13, 10, 8, 10, 57
1555, 24, 12, 3, 10, 10, 59
1560, 20, 13, 8, 4, 13, 58
1565, 20, 14, 10, 5, 11, 60
1570, 10, 16, 6, 5, 10, 47
1575, 10, 20, 6, 4, 12, 52
1580, 14, 19, 6, 6, 9, 54
1585, 14, 10, 4, 6, 9, 43
1590, 15, 6, 7, 3, 8, 39
1595, 10, 7, 6, 3, 8, 34
1600, 16, 9, 4, 5, 11, 45
1605, 8, 10, 6, 2, 8, 34
1610, 23, 9, 5, 3, 11, 51
1615, 13, 9, 6, 4, 10, 42
1620, 11, 17, 3, 4, 11, 46
1625, 13, 6, 8, 3, 8, 38
1630, 9, 7, 5, 4, 9, 34
1635, 8, 3, 3, 3, 7, 24
1640, 10, 12, 7, 2, 3, 34
1645, 6, 10, 3, 3, 4, 26
1650, 2, 10, 3, 2, 6, 23
1655, 11, 3, 5, 5, 5, 29
1660, 12, 9, 3, 4, 5, 33
1665, 6, 4, 2, 4, 6, 22
1670, 10, 9, 2, 2, 4, 27
1675, 7, 9, 3, 1, 4, 24
1680, 4, 4, 3, 1, 5, 17
1685, 4, 3, 3, 0, 6, 16
1690, 5, 5, 2, 2, 1, 15
1695, 5, 2, 3, 2, 0, 12
1700, 4, 5, 1, 3, 3, 16
1705, 7, 7, 3, 1, 2, 20
1710, 4, 4, 2, 1, 3, 14
1715, 2, 1, 0, 1, 4, 8
1720, 3, 3, 2, 0, 3, 11
1725, 4, 5, 4, 2, 3, 18
1730, 4, 6, 2, 0, 4, 16
1735, 5, 5, 1, 1, 2, 14
1740, 4, 4, 2, 1, 2, 13
1745, 2, 1, 0, 1, 0, 4
1750, 3, 3, 0, 1, 1, 8
1755, 6, 2, 1, 0, 1, 10
1760, 3, 15, 7, 2, 1, 28
1765, 4, 9, 6, 2, 2, 23
1770, 2, 3, 0, 2, 1, 8
1775, 1, 0, 2, 0, 0, 3
1780, 3, 6, 2, 0, 2, 13
1785, 3, 1, 1, 0, 3, 8
1790, 0, 1, 0, 1, 0, 2
1795, 0, 0, 1, 1, 1, 3
1800, 1, 2, 1, 1, 0, 5
1805, 4, 1, 1, 0, 2, 8
1810, 1, 0, 1, 0, 1, 3
1815, 0, 2, 1, 0, 0, 3
1820, 0, 1, 0, 0, 2, 3
1825, 1, 0, 0, 0, 1, 2
1830, 0, 3, 0, 0, 0, 3
1835, 0, 0, 0, 1, 1, 2
1840, 0, 0, 2, 0, 0, 2
1845, 1, 0, 2, 1, 3, 7
1850, 0, 2, 0, 0, 1, 3
1855, 3, 1, 0, 0, 1, 5
1860, 0, 1, 1, 0, 1, 3
1865, 0, 0, 0, 0, 0, 0
1870, 1, 0, 1, 0, 0, 2
1875, 0, 0, 1, 0, 0, 1
1880, 2, 0, 0, 0, 1, 3
1885, 0, 1, 0, 0, 0, 1
1890, 1, 1, 0, 0, 0, 2
1895, 1, 0, 0, 1, 1, 3
1900, 0, 3, 1, 0, 1, 5
1905, 0, 0, 0, 0, 0, 0
1910, 0, 2, 2, 0, 1, 5
1915, 0, 0, 0, 0, 0, 0
1920, 1, 1, 1, 0, 1, 4
1925, 0, 0, 0, 0, 0, 0
1930, 0, 0, 0, 0, 1, 1
1935, 1, 2, 0, 0, 1, 4
1940, 0, 1, 1, 0, 0, 2
1945, 0, 1, 0, 0, 0, 1
1950, 2, 2, 0, 0, 0, 4
1955, 1, 1, 0, 0, 0, 2
1960, 0, 1, 0, 1, 0, 2
1965, 0, 0, 0, 0, 0, 0
1970, 2, 1, 0, 0, 1, 4
1975, 0, 2, 0, 0, 0, 2
1980, 0, 2, 0, 0, 1, 3
1985, 1, 2, 0, 0, 0, 3
1990, 0, 2, 0, 0, 1, 3
1995, 0, 2, 0, 0, 0, 2
2000, 1, 0, 0, 0, 0, 1
2005, 0, 0, 0, 0, 0, 0
2010, 1, 1, 0, 0, 1, 3
2015, 1, 1, 1, 0, 0, 3
2020, 0, 1, 0, 0, 0, 1
2025, 0, 0, 0, 0, 0, 0
2030, 1, 0, 0, 0, 0, 1
2035, 0, 0, 0, 0, 0, 0
2040, 1, 1, 0, 0, 0, 2
2045, 0, 0, 0, 0, 0, 0
2050, 2, 1, 0, 0, 0, 3
2055, 1, 0, 0, 1, 0, 2
2060, 1, 0, 1, 0, 0, 2
2065, 1, 0, 0, 0, 0, 1
2070, 0, 1, 0, 1, 0, 2
2075, 0, 0, 0, 0, 1, 1
2080, 0, 2, 0, 0, 0, 2
2085, 0, 1, 1, 0, 0, 2
2090, 1, 1, 0, 0, 0, 2
2095, 0, 1, 1, 0, 1, 3
2100, 1, 1, 0, 1, 0, 3
2105, 1, 0, 0, 1, 0, 2
2110, 1, 1, 1, 0, 1, 4
2115, 0, 1, 0, 0, 2, 3
2120, 0, 1, 0, 0, 0, 1
2125, 1, 0, 0, 0, 0, 1
2130, 0, 0, 0, 0, 0, 0
2135, 0, 0, 0, 0, 0, 0
2140, 0, 0, 0, 0, 0, 0
2145, 0, 0, 0, 1, 0, 1
2150, 1, 1, 1, 0, 1, 4
2155, 1, 1, 0, 0, 0, 2
2160, 0, 1, 0, 0, 0, 1
2165, 2, 0, 0, 0, 0, 2
2170, 0, 0, 0, 1, 0, 1
2175, 0, 2, 0, 0, 0, 2
2180, 0, 0, 0, 0, 1, 1
2185, 0, 0, 0, 0, 0, 0
2190, 0, 1, 0, 0, 0, 1
2195, 0, 0, 0, 0, 0, 0
2200, 1, 2, 0, 0, 0, 3
2205, 2, 2, 2, 0, 0, 6
2210, 1, 0, 0, 0, 1, 2
2215, 1, 0, 0, 0, 1, 2
2220, 0, 0, 0, 0, 0, 0
2225, 0, 0, 0, 0, 0, 0
2230, 2, 1, 0, 0, 1, 4
2235, 0, 1, 0, 0, 0, 1
2240, 0, 1, 1, 0, 0, 2
2245, 2, 0, 0, 1, 0, 3
2250, 1, 0, 0, 0, 1, 2
2255, 1, 1, 0, 0, 0, 2
2260, 1, 0, 0, 0, 1, 2
2265, 0, 1, 0, 0, 0, 1
2270, 1, 1, 0, 0, 1, 3
2275, 1, 0, 0, 0, 1, 2
2280, 0, 1, 1, 0, 1, 3
2285, 1, 1, 3, 0, 0, 5
2290, 1, 0, 0, 0, 0, 1
2295, 0, 1, 0, 0, 0, 1
2300, 0, 0, 0, 0, 0, 0
2305, 0, 0, 1, 0, 0, 1
2310, 0, 0, 0, 0, 1, 1
2315, 0, 0, 0, 0, 1, 1
2320, 0, 0, 0, 0, 1, 1
2325, 0, 1, 0, 1, 0, 2
2330, 0, 1, 0, 0, 0, 1
2335, 0, 1, 0, 0, 0, 1
2340, 3, 0, 0, 0, 0, 3
2345, 0, 0, 0, 0, 1, 1
2350, 0, 0, 1, 0, 0, 1
2355, 0, 0, 0, 0, 2, 2
2360, 1, 0, 1, 0, 0, 2
2365, 0, 0, 2, 1, 0, 3
2370, 1, 1, 0, 0, 1, 3
2375, 0, 2, 0, 0, 0, 2
2380, 1, 0, 0, 0, 1, 2
2385, 0, 1, 0, 0, 2, 3
2390, 0, 0, 1, 0, 0, 1
2395, 0, 1, 1, 0, 0, 2
2400, 0, 0, 1, 0, 0, 1
2405, 0, 0, 0, 0, 1, 1
2410, 0, 0, 0, 1, 0, 1
2415, 1, 1, 0, 0, 0, 2
2420, 0, 0, 0, 0, 1, 1
2425, 0, 0, 0, 0, 0, 0
2430, 0, 1, 0, 0, 0, 1
2435, 0, 0, 0, 0, 1, 1
2440, 0, 1, 0, 0, 0, 1
2445, 0, 0, 0, 0, 0, 0
2450, 0, 1, 0, 0, 0, 1
2455, 0, 0, 1, 0, 0, 1
2460, 0, 0, 0, 0, 1, 1
2465, 0, 0, 0, 0, 0, 0
2470, 0, 0, 0, 0, 1, 1
2475, 0, 0, 0, 0, 0, 0
2480, 0, 0, 0, 0, 0, 0
2485, 0, 1, 0, 0, 0, 1
2490, 0, 0, 0, 0, 0, 0
2495, 0, 1, 0, 0, 0, 1
2500, 0, 0, 0, 0, 0, 0
2505, 0, 0, 0, 0, 0, 0
2510, 0, 0, 0, 0, 0, 0
2515, 0, 0, 0, 0, 0, 0
2520, 0, 1, 0, 0, 0, 1
2525, 0, 0, 0, 0, 0, 0
2530, 0, 0, 0, 0, 0, 0
2535, 0, 0, 0, 0, 0, 0
2540, 0, 0, 0, 0, 0, 0
2545, 0, 0, 0, 0, 0, 0
2550, 0, 0, 0, 0, 0, 0
2555, 0, 0, 0, 0, 0, 0
2560, 0, 1, 0, 0, 1, 2
2565, 0, 0, 0, 0, 0, 0
2570, 1, 0, 0, 0, 0, 1
2575, 0, 0, 0, 0, 1, 1
2580, 0, 2, 0, 0, 0, 2
2585, 0, 0, 0, 0, 0, 0
2590, 1, 0, 0, 0, 0, 1
2595, 0, 1, 0, 0, 0, 1
2600, 0, 1, 0, 0, 0, 1
2605, 0, 2, 2, 0, 0, 4
2610, 3, 8, 2, 0, 2, 15
2615, 1, 2, 0, 2, 1, 6
2620, 0, 0, 0, 0, 0, 0
2625, 0, 0, 0, 0, 0, 0
2630, 0, 0, 0, 0, 0, 0
2635, 0, 0, 0, 0, 0, 0
2640, 0, 1, 0, 0, 0, 1
2645, 0, 0, 0, 0, 0, 0
2650, 0, 0, 0, 0, 0, 0
2655, 0, 0, 0, 0, 0, 0
2660, 0, 0, 0, 0, 0, 0
2665, 0, 0, 0, 0, 0, 0
2670, 0, 0, 0, 0, 0, 0
2675, 0, 0, 0, 0, 0, 0
2680, 0, 0, 0, 0, 0, 0
2685, 0, 0, 0, 0, 0, 0
2690, 0, 0, 0, 0, 0, 0
2695, 0, 0, 0, 0, 0, 0
2700, 0, 0, 0, 0, 0, 0
2705, 0, 0, 0, 0, 0, 0
2710, 0, 0, 0, 0, 0, 0
2715, 0, 0, 0, 0, 0, 0
2720, 0, 0, 0, 0, 0, 0
2725, 0, 0, 0, 0, 0, 0
2730, 0, 0, 0, 0, 0, 0
2735, 0, 0, 0, 0, 0, 0
2740, 0, 0, 0, 0, 0, 0
2745, 0, 0, 0, 0, 0, 0
2750, 0, 0, 0, 0, 0, 0
2755, 1, 0, 0, 0, 0, 1
2760, 0, 0, 0, 0, 0, 0
2765, 0, 0, 0, 0, 0, 0
2770, 0, 0, 1, 0, 0, 1
2775, 0, 0, 0, 0, 0, 0
2780, 0, 0, 0, 0, 0, 0
2785, 0, 0, 0, 0, 0, 0
2790, 0, 0, 0, 0, 0, 0
2795, 0, 0, 0, 0, 0, 0
2800, 0, 0, 0, 0, 0, 0
2805, 0, 0, 0, 0, 0, 0
2810, 0, 0, 0, 0, 0, 0
2815, 0, 0, 1, 0, 0, 1
2820, 0, 0, 0, 0, 0, 0
2825, 0, 0, 0, 0, 0, 0
2830, 0, 0, 0, 0, 0, 0
2835, 0, 0, 0, 0, 0, 0
2840, 0, 0, 0, 0, 0, 0
2845, 0, 0, 0, 0, 0, 0
2850, 0, 0, 0, 0, 0, 0
2855, 0, 0, 0, 0, 0, 0
2860, 0, 0, 0, 0, 0, 0
2865, 0, 0, 1, 0, 0, 1
2870, 0, 0, 0, 0, 0, 0
2875, 0, 0, 0, 0, 0, 0
2880, 0, 0, 0, 0, 0, 0
2885, 0, 0, 0, 0, 0, 0
2890, 0, 0, 0, 0, 0, 0
2895, 0, 0, 0, 0, 0, 0
2900, 0, 0, 0, 0, 0, 0
2905, 0, 0, 0, 0, 0, 0
2910, 0, 0, 0, 0, 0, 0
2915, 0, 0, 0, 0, 0, 0
2920, 0, 0, 0, 0, 0, 0
2925, 0, 0, 0, 0, 0, 0
2930, 0, 0, 0, 0, 0, 0
2935, 0, 0, 0, 0, 0, 0
2940, 0, 1, 0, 0, 0, 1
2945, 0, 0, 0, 0, 0, 0
2950, 0, 0, 0, 0, 0, 0
2955, 0, 0, 0, 0, 0, 0
2960, 0, 0, 0, 0, 0, 0
2965, 0, 0, 0, 0, 0, 0
2970, 0, 0, 0, 0, 0, 0
2975, 0, 0, 0, 0, 0, 0
2980, 0, 0, 0, 0, 0, 0
2985, 0, 0, 0, 0, 0, 0
2990, 1, 0, 0, 0, 0, 1
2995, 0, 0, 0, 0, 0, 0
3000, 0, 0, 0, 0, 0, 0
3005, 0, 0, 0, 0, 0, 0
3010, 0, 0, 0, 0, 0, 0
3015, 0, 0, 0, 0, 0, 0
3020, 0, 0, 0, 0, 0, 0
3025, 0, 0, 0, 0, 0, 0
3030, 0, 0, 0, 0, 0, 0
3035, 0, 0, 0, 0, 0, 0
3040, 0, 0, 0, 0, 0, 0
3045, 0, 1, 0, 0, 0, 1
3050, 0, 0, 0, 0, 0, 0
3055, 0, 0, 0, 0, 0, 0
3060, 0, 0, 0, 0, 0, 0
3065, 0, 0, 0, 0, 0, 0
3070, 0, 0, 0, 0, 0, 0
3075, 0, 0, 0, 0, 0, 0
3080, 0, 0, 0, 0, 0, 0
3085, 0, 0, 0, 0, 0, 0
3090, 0, 0, 0, 0, 0, 0
3095, 0, 0, 0, 0, 0, 0
3100, 0, 0, 0, 0, 0, 0
3105, 0, 0, 0, 0, 0, 0
3110, 0, 0, 0, 0, 0, 0
3115, 0, 0, 0, 0, 0, 0
3120, 0, 0, 0, 0, 0, 0
3125, 0, 0, 0, 0, 0, 0
3130, 0, 0, 0, 0, 0, 0
3135, 0, 0, 0, 0, 0, 0
3140, 0, 0, 0, 0, 0, 0
3145, 0, 0, 0, 0, 0, 0
3150, 0, 0, 0, 0, 0, 0
3155, 0, 0, 0, 0, 0, 0
3160, 0, 0, 0, 0, 0, 0
3165, 0, 0, 0, 0, 0, 0
3170, 0, 0, 0, 0, 0, 0
3175, 0, 0, 0, 0, 0, 0
3180, 0, 0, 0, 0, 0, 0
3185, 0, 0, 0, 0, 0, 0
3190, 0, 0, 0, 0, 0, 0
3195, 0, 0, 0, 0, 0, 0
3200, 0, 0, 0, 0, 0, 0
3205, 0, 0, 0, 0, 0, 0
3210, 0, 0, 0, 0, 0, 0
3215, 0, 0, 0, 0, 0, 0
3220, 0, 0, 0, 0, 0, 0
3225, 0, 0, 0, 0, 0, 0
3230, 0, 0, 0, 0, 0, 0
3235, 0, 0, 0, 0, 0, 0
3240, 0, 0, 0, 0, 0, 0
3245, 0, 1, 0, 0, 0, 1
3250, 0, 0, 0, 0, 0, 0
3255, 0, 0, 0, 0, 0, 0
3260, 0, 0, 0, 0, 0, 0
3265, 0, 0, 0, 0, 0, 0
3270, 0, 0, 0, 0, 0, 0
3275, 0, 0, 0, 0, 0, 0
3280, 0, 0, 0, 0, 0, 0
3285, 0, 0, 0, 0, 0, 0
3290, 0, 0, 0, 0, 0, 0
3295, 0, 0, 0, 0, 0, 0
3300, 0, 0, 0, 0, 0, 0
3305, 0, 0, 0, 0, 0, 0
3310, 0, 0, 0, 0, 0, 0
3315, 0, 0, 0, 0, 0, 0
3320, 0, 0, 0, 0, 0, 0
3325, 0, 0, 0, 0, 0, 0
3330, 0, 1, 0, 0, 0, 1
3335, 0, 0, 0, 0, 0, 0
3340, 0, 0, 0, 0, 0, 0
3345, 0, 0, 0, 0, 0, 0
3350, 0, 0, 0, 0, 0, 0
3355, 0, 0, 0, 0, 0, 0
3360, 0, 0, 0, 0, 0, 0
3365, 0, 0, 0, 0, 0, 0
3370, 0, 0, 0, 0, 0, 0
3375, 0, 0, 0, 0, 0, 0
3380, 0, 1, 0, 0, 0, 1
3385, 0, 0, 0, 0, 0, 0
3390, 0, 0, 0, 0, 0, 0
3395, 0, 0, 0, 0, 0, 0
3400, 0, 0, 0, 0, 0, 0
3405, 0, 0, 0, 0, 0, 0
3410, 0, 0, 0, 0, 0, 0
3415, 0, 0, 0, 0, 0, 0
3420, 0, 0, 0, 0, 0, 0
3425, 0, 0, 0, 0, 0, 0
3430, 0, 0, 0, 0, 0, 0
3435, 0, 0, 0, 0, 0, 0
3440, 0, 0, 0, 0, 0, 0
3445, 0, 0, 0, 0, 0, 0
3450, 0, 0, 0, 0, 0, 0
3455, 0, 0, 0, 0, 0, 0
3460, 0, 0, 0, 0, 0, 0
3465, 0, 0, 0, 0, 0, 0
3470, 0, 0, 0, 0, 0, 0
3475, 0, 0, 0, 0, 0, 0
3480, 0, 0, 0, 0, 0, 0
3485, 0, 0, 0, 0, 0, 0
3490, 0, 0, 0, 0, 0, 0
3495, 0, 0, 0, 0, 0, 0
3500, 0, 0, 0, 0, 0, 0
3505, 0, 0, 0, 0, 0, 0
3510, 0, 0, 0, 0, 0, 0
3515, 0, 0, 0, 0, 0, 0
3520, 0, 0, 0, 0, 0, 0
3525, 0, 0, 0, 0, 0, 0
3530, 0, 0, 0, 0, 0, 0
3535, 0, 0, 0, 0, 0, 0
3540, 0, 0, 0, 0, 0, 0
3545, 0, 0, 0, 0, 0, 0
3550, 0, 0, 0, 0, 0, 0
3555, 0, 0, 0, 0, 0, 0
3560, 0, 0, 0, 0, 0, 0
3565, 0, 0, 0, 0, 0, 0
3570, 0, 0, 0, 0, 0, 0
3575, 0, 0, 0, 0, 0, 0
3580, 0, 0, 0, 0, 0, 0
3585, 0, 0, 0, 0, 0, 0
3590, 0, 0, 0, 0, 0, 0
3595, 0, 0, 0, 0, 0, 0
3600, 0, 0, 0, 0, 0, 0
3605, 0, 0, 0, 0, 0, 0
3610, 0, 0, 0, 0, 0, 0
3615, 0, 0, 0, 0, 0, 0
3620, 0, 0, 0, 0, 0, 0
3625, 0, 0, 0, 0, 0, 0
3630, 0, 0, 0, 0, 0, 0
3635, 0, 0, 0, 0, 0, 0
3640, 0, 0, 0, 0, 0, 0
3645, 0, 0, 0, 0, 0, 0
3650, 0, 1, 0, 0, 0, 1
3655, 0, 0, 0, 0, 0, 0
3660, 0, 0, 0, 0, 0, 0
3665, 0, 0, 0, 0, 0, 0
3670, 0, 0, 0, 0, 0, 0
3675, 0, 0, 0, 0, 0, 0
3680, 0, 0, 0, 0, 0, 0
3685, 0, 0, 0, 0, 0, 0
3690, 0, 0, 0, 0, 0, 0
3695, 0, 0, 0, 0, 0, 0
3700, 0, 0, 0, 0, 0, 0
3705, 0, 0, 0, 0, 0, 0
3710, 0, 0, 0, 0, 0, 0
3715, 0, 1, 0, 0, 0, 1
3720, 0, 0, 0, 0, 0, 0
3725, 0, 0, 0, 0, 0, 0
3730, 0, 0, 0, 0, 0, 0
3735, 0, 0, 0, 0, 0, 0
3740, 0, 0, 0, 0, 0, 0
3745, 0, 0, 0, 0, 0, 0
3750, 0, 0, 0, 0, 0, 0
3755, 0, 0, 0, 0, 0, 0
3760, 0, 0, 0, 0, 0, 0
3765, 0, 0, 0, 0, 0, 0
3770, 0, 0, 0, 0, 0, 0
3775, 0, 0, 0, 0, 0, 0
3780, 0, 0, 0, 0, 0, 0
3785, 0, 0, 0, 0, 0, 0
3790, 0, 0, 0, 0, 0, 0
3795, 0, 0, 0, 0, 0, 0
3800, 0, 0, 0, 0, 0, 0
3805, 0, 0, 0, 0, 0, 0
3810, 0, 0, 0, 0, 0, 0
3815, 0, 0, 0, 0, 0, 0
3820, 0, 0, 0, 0, 0, 0
3825, 0, 0, 0, 0, 0, 0
3830, 0, 0, 0, 0, 0, 0
3835, 0, 0, 0, 0, 0, 0
3840, 0, 0, 0, 0, 0, 0
3845, 0, 0, 0, 0, 0, 0
3850, 0, 0, 0, 0, 0, 0
3855, 0, 0, 0, 0, 0, 0
3860, 0, 0, 0, 0, 0, 0
3865, 0, 0, 0, 0, 0, 0
3870, 0, 0, 0, 0, 0, 0
3875, 0, 0, 0, 0, 0, 0
3880, 0, 0, 0, 0, 0, 0
3885, 0, 0, 0, 0, 0, 0
3890, 0, 0, 0, 0, 0, 0
3895, 0, 0, 0, 0, 0, 0
3900, 0, 0, 0, 0, 0, 0
3905, 0, 0, 0, 0, 0, 0
3910, 0, 0, 0, 0, 0, 0
3915, 0, 0, 0, 0, 0, 0
3920, 0, 0, 0, 0, 0, 0
3925, 0, 0, 0, 0, 0, 0
3930, 0, 0, 0, 0, 0, 0
3935, 0, 0, 0, 0, 0, 0
3940, 0, 0, 0, 0, 0, 0
3945, 0, 0, 0, 0, 0, 0
3950, 0, 0, 0, 0, 0, 0
3955, 0, 0, 0, 0, 0, 0
3960, 0, 0, 0, 0, 0, 0
3965, 0, 0, 0, 0, 0, 0
3970, 0, 0, 0, 0, 0, 0
3975, 0, 0, 0, 0, 0, 0
3980, 0, 0, 0, 0, 0, 0
3985, 0, 0, 0, 0, 0, 0
3990, 0, 0, 0, 0, 0, 0
3995, 0, 1, 0, 0, 0, 1
4000, 0, 0, 0, 0, 0, 0
4005, 0, 0, 0, 0, 0, 0
4010, 0, 0, 0, 0, 0, 0
4015, 0, 0, 0, 0, 0, 0
4020, 0, 0, 0, 0, 0, 0
4025, 0, 0, 0, 0, 0, 0
4030, 0, 0, 0, 0, 0, 0
4035, 0, 0, 0, 0, 0, 0
4040, 0, 0, 0, 0, 0, 0
4045, 0, 0, 0, 0, 0, 0
4050, 0, 0, 0, 0, 0, 0
4055, 0, 0, 0, 0, 0, 0
4060, 0, 0, 0, 0, 0, 0
4065, 0, 0, 0, 0, 0, 0
4070, 0, 0, 0, 0, 0, 0
4075, 0, 0, 0, 0, 0, 0
4080, 0, 0, 0, 0, 0, 0
4085, 0, 0, 0, 0, 0, 0
4090, 0, 0, 0, 0, 0, 0
4095, 0, 0, 0, 0, 0, 0
4100, 0, 1, 0, 0, 0, 1
4105, 0, 0, 0, 0, 0, 0
4110, 0, 0, 0, 0, 0, 0
4115, 0, 0, 0, 0, 0, 0
4120, 0, 0, 0, 0, 0, 0
4125, 0, 0, 0, 0, 0, 0
4130, 0, 1, 0, 0, 0, 1
4135, 0, 0, 0, 0, 0, 0
4140, 0, 0, 0, 0, 0, 0
4145, 0, 1, 0, 0, 0, 1
4150, 0, 0, 0, 0, 0, 0
4155, 0, 0, 0, 0, 0, 0
4160, 0, 0, 0, 0, 0, 0
4165, 0, 0, 0, 0, 0, 0
4170, 0, 0, 0, 0, 0, 0
4175, 0, 0, 0, 0, 0, 0
4180, 0, 0, 0, 0, 0, 0
4185, 0, 0, 0, 0, 0, 0
4190, 0, 0, 0, 0, 0, 0
4195, 0, 0, 0, 0, 0, 0
4200, 0, 0, 0, 0, 0, 0
4205, 0, 1, 0, 0, 0, 1
4210, 0, 0, 0, 0, 0, 0
4215, 0, 0, 0, 0, 0, 0
4220, 0, 0, 0, 0, 0, 0
4225, 0, 0, 0, 0, 0, 0
4230, 0, 0, 0, 0, 0, 0
4235, 0, 1, 0, 0, 0, 1
4240, 0, 0, 0, 0, 0, 0
4245, 0, 0, 0, 0, 0, 0
4250, 0, 0, 0, 0, 0, 0
4255, 0, 0, 0, 0, 0, 0
4260, 0, 0, 0, 0, 0, 0
4265, 0, 0, 0, 0, 0, 0
4270, 0, 0, 0, 0, 0, 0
4275, 0, 0, 0, 0, 0, 0
4280, 0, 0, 0, 0, 0, 0
4285, 0, 0, 0, 0, 0, 0
4290, 0, 0, 0, 0, 0, 0
4295, 0, 0, 0, 0, 0, 0
4300, 0, 0, 0, 0, 0, 0
4305, 0, 0, 0, 0, 0, 0
4310, 0, 0, 0, 0, 0, 0
4315, 0, 0, 0, 0, 0, 0
4320, 0, 0, 0, 0, 0, 0
4325, 0, 0, 0, 0, 0, 0
4330, 0, 0, 0, 0, 0, 0
4335, 0, 0, 0, 0, 0, 0
4340, 0, 1, 0, 0, 0, 1
4345, 0, 0, 0, 0, 0, 0
4350, 0, 0, 0, 0, 0, 0
4355, 0, 1, 0, 0, 0, 1
4360, 0, 0, 0, 0, 0, 0
4365, 0, 0, 0, 0, 0, 0
4370, 0, 1, 0, 0, 0, 1
4375, 0, 0, 0, 0, 0, 0
4380, 0, 0, 0, 0, 0, 0
4385, 0, 0, 0, 0, 0, 0
4390, 0, 0, 0, 0, 0, 0
4395, 0, 1, 0, 0, 0, 1
4400, 0, 0, 0, 0, 0, 0
4405, 0, 0, 0, 0, 0, 0
4410, 0, 0, 0, 0, 0, 0
4415, 0, 0, 0, 0, 0, 0
4420, 0, 0, 0, 0, 0, 0
4425, 0, 0, 0, 0, 0, 0
4430, 0, 0, 0, 0, 0, 0
4435, 0, 0, 1, 0, 0, 1
4440, 0, 1, 0, 0, 0, 1
4445, 0, 0, 0, 0, 0, 0
4450, 0, 0, 0, 0, 0, 0
4455, 0, 0, 0, 0, 0, 0
4460, 0, 0, 1, 0, 0, 1
4465, 0, 0, 0, 0, 0, 0
4470, 0, 0, 0, 0, 0, 0
4475, 0, 0, 0, 0, 0, 0
4480, 0, 1, 0, 0, 0, 1
4485, 0, 0, 0, 0, 0, 0
4490, 0, 0, 0, 0, 0, 0
4495, 0, 0, 0, 0, 0, 0
4500, 0, 0, 0, 0, 0, 0
4505, 0, 0, 0, 0, 0, 0
4510, 0, 0, 0, 0, 0, 0
4515, 0, 0, 0, 0, 0, 0
4520, 0, 0, 0, 0, 0, 0
4525, 0, 0, 0, 0, 0, 0
4530, 0, 0, 0, 0, 0, 0
4535, 0, 0, 0, 0, 0, 0
4540, 0, 1, 0, 0, 0, 1
4545, 0, 1, 0, 0, 0, 1
4550, 0, 1, 1, 0, 0, 2
4555, 0, 0, 0, 0, 0, 0
4560, 0, 0, 0, 0, 0, 0
4565, 0, 0, 0, 0, 0, 0
4570, 0, 0, 0, 0, 0, 0
4575, 0, 0, 0, 0, 0, 0
4580, 0, 0, 0, 0, 0, 0
4585, 0, 0, 0, 0, 0, 0
4590, 0, 0, 0, 0, 0, 0
4595, 0, 0, 0, 0, 0, 0
4600, 0, 0, 0, 0, 0, 0
4605, 0, 0, 0, 0, 0, 0
4610, 0, 0, 0, 0, 0, 0
4615, 0, 0, 0, 0, 0, 0
4620, 0, 0, 0, 0, 0, 0
4625, 0, 0, 0, 0, 0, 0
4630, 0, 0, 0, 0, 0, 0
4635, 0, 0, 0, 0, 0, 0
4640, 0, 0, 0, 0, 0, 0
4645, 0, 0, 0, 0, 0, 0
4650, 0, 0, 0, 0, 0, 0
4655, 0, 0, 0, 0, 0, 0
4660, 0, 0, 0, 0, 0, 0
4665, 0, 0, 0, 0, 0, 0
4670, 0, 0, 0, 0, 0, 0
4675, 0, 0, 0, 0, 0, 0
4680, 0, 0, 0, 0, 0, 0
4685, 0, 0, 1, 0, 0, 1
4690, 0, 0, 0, 0, 0, 0
4695, 0, 0, 0, 0, 0, 0
4700, 0, 1, 0, 0, 0, 1
4705, 0, 0, 0, 0, 0, 0
4710, 0, 0, 0, 0, 0, 0
4715, 0, 0, 0, 0, 0, 0
4720, 0, 0, 0, 0, 0, 0
4725, 0, 0, 0, 0, 0, 0
4730, 0, 0, 0, 0, 0, 0
4735, 0, 0, 0, 0, 0, 0
4740, 0, 0, 0, 0, 0, 0
4745, 0, 0, 0, 0, 0, 0
4750, 0, 0, 0, 0, 0, 0
4755, 0, 0, 0, 0, 0, 0
4760, 0, 0, 0, 0, 0, 0
4765, 0, 0, 0, 0, 0, 0
4770, 0, 0, 0, 0, 0, 0
4775, 0, 0, 0, 0, 0, 0
4780, 0, 1, 0, 0, 0, 1
4785, 0, 0, 0, 0, 0, 0
4790, 0, 0, 0, 0, 0, 0
4795, 0, 0, 0, 0, 0, 0
4800, 0, 0, 0, 0, 0, 0
4805, 0, 0, 0, 0, 0, 0
4810, 0, 0, 0, 0, 0, 0
4815, 0, 0, 0, 0, 0, 0
4820, 0, 1, 0, 0, 0, 1
4825, 0, 1, 0, 0, 0, 1
4830, 0, 0, 0, 0, 0, 0
4835, 0, 0, 0, 0, 0, 0
4840, 0, 0, 0, 0, 0, 0
4845, 0, 1, 0, 0, 0, 1
4850, 0, 1, 0, 0, 0, 1
4855, 0, 0, 0, 0, 0, 0
4860, 0, 1, 0, 0, 0, 1
4865, 0, 1, 0, 0, 0, 1
4870, 0, 0, 1, 0, 0, 1
4875, 0, 0, 0, 0, 0, 0
4880, 0, 0, 0, 0, 0, 0
4885, 0, 0, 0, 0, 0, 0
4890, 0, 0, 0, 0, 0, 0
4895, 0, 0, 0, 0, 0, 0
4900, 0, 0, 0, 0, 0, 0
4905, 0, 0, 0, 0, 0, 0
4910, 0, 0, 0, 0, 0, 0
4915, 0, 0, 0, 0, 0, 0
4920, 0, 0, 0, 0, 0, 0
4925, 0, 0, 0, 0, 0, 0
4930, 0, 0, 0, 0, 0, 0
4935, 0, 0, 0, 0, 0, 0
4940, 0, 0, 0, 0, 0, 0
4945, 0, 0, 0, 0, 0, 0
4950, 0, 1, 0, 0, 0, 1
4955, 0, 0, 0, 0, 0, 0
4960, 0, 0, 0, 0, 0, 0
4965, 0, 0, 0, 0, 0, 0
4970, 0, 2, 0, 0, 0, 2
4975, 0, 0, 0, 0, 0, 0
4980, 0, 0, 0, 0, 0, 0
4985, 0, 0, 0, 0, 0, 0
4990, 0, 0, 0, 0, 0, 0
4995, 0, 0, 0, 0, 0, 0
