energy, EnrBEGe, EnrCoax, EnrCoax_2, EnrInvCoax, EnrBEGe_2, EnrAll
989, 1146, 1008, 445, 329, 768, 3696
1004, 1165, 989, 461, 294, 750, 3659
1019, 1073, 922, 430, 307, 740, 3472
1034, 1040, 928, 434, 282, 738, 3422
1049, 1012, 923, 415, 299, 693, 3342
1064, 988, 923, 398, 256, 709, 3274
1079, 1022, 876, 407, 254, 699, 3258
1094, 1004, 839, 397, 276, 654, 3170
1109, 964, 893, 367, 356, 672, 3252
1124, 905, 813, 338, 327, 679, 3062
1139, 888, 744, 345, 238, 653, 2868
1154, 866, 770, 345, 266, 604, 2851
1169, 900, 787, 331, 272, 646, 2936
1184, 896, 779, 334, 232, 591, 2832
1199, 907, 713, 348, 247, 547, 2762
1214, 825, 724, 334, 219, 572, 2674
1229, 876, 701, 302, 248, 552, 2679
1244, 746, 680, 289, 205, 520, 2440
1259, 785, 634, 281, 186, 471, 2357
1274, 725, 638, 305, 211, 507, 2386
1289, 722, 665, 265, 197, 499, 2348
1304, 603, 585, 232, 193, 394, 2007
1319, 602, 529, 245, 163, 419, 1958
1334, 502, 504, 221, 168, 345, 1740
1349, 467, 422, 175, 138, 328, 1530
1364, 435, 397, 184, 152, 329, 1497
1379, 391, 391, 160, 107, 235, 1284
1394, 350, 335, 156, 130, 226, 1197
1409, 286, 289, 138, 102, 180, 995
1424, 265, 282, 115, 97, 188, 947
1439, 232, 249, 106, 95, 160, 842
1454, 1746, 1939, 778, 945, 1129, 6537
1469, 188, 184, 74, 61, 140, 647
1484, 162, 162, 65, 59, 110, 558
1499, 153, 166, 77, 54, 112, 562
1514, 2580, 3273, 1388, 1099, 1759, 10099
1529, 116, 104, 75, 38, 76, 409
1544, 101, 82, 35, 31, 50, 299
1559, 79, 69, 34, 20, 51, 253
1574, 74, 85, 38, 23, 44, 264
1589, 60, 52, 32, 20, 43, 207
1604, 58, 39, 27, 17, 40, 181
1619, 59, 59, 25, 22, 51, 216
1634, 38, 44, 18, 16, 26, 142
1649, 38, 43, 18, 16, 24, 139
1664, 39, 34, 17, 13, 24, 127
1679, 29, 22, 15, 5, 22, 93
1694, 32, 23, 11, 7, 10, 83
1709, 16, 22, 9, 8, 20, 75
1724, 34, 35, 16, 15, 26, 126
1739, 26, 16, 8, 4, 12, 66
1754, 59, 62, 33, 27, 30, 211
1769, 11, 18, 7, 5, 4, 45
1784, 21, 9, 6, 6, 8, 50
1799, 8, 7, 6, 9, 10, 40
1814, 6, 7, 1, 4, 9, 27
1829, 8, 11, 3, 5, 7, 34
1844, 11, 14, 5, 3, 15, 48
1859, 4, 11, 4, 3, 5, 27
1874, 4, 8, 1, 4, 9, 26
1889, 12, 11, 2, 4, 6, 35
1904, 7, 9, 7, 3, 4, 30
1919, 11, 9, 6, 5, 6, 37
1934, 10, 6, 3, 0, 5, 24
1949, 9, 7, 0, 5, 7, 28
1964, 12, 11, 2, 2, 5, 32
1979, 8, 11, 0, 4, 6, 29
1994, 5, 8, 3, 3, 2, 21
2009, 6, 6, 3, 3, 4, 22
2024, 7, 5, 0, 7, 4, 23
2039, 7, 8, 0, 2, 5, 22
2054, 9, 7, 2, 3, 4, 25
2069, 0, 9, 2, 2, 4, 17
2084, 11, 5, 3, 0, 7, 26
2099, 13, 8, 4, 4, 12, 41
2114, 5, 11, 3, 1, 14, 34
2129, 2, 3, 0, 3, 5, 13
2144, 5, 4, 5, 2, 4, 20
2159, 5, 2, 0, 3, 2, 12
2174, 6, 5, 2, 0, 3, 16
2189, 9, 9, 3, 9, 10, 40
2204, 23, 9, 4, 8, 6, 50
2219, 3, 3, 5, 1, 4, 16
2234, 5, 4, 4, 4, 6, 23
2249, 5, 3, 5, 2, 6, 21
2264, 12, 6, 0, 1, 3, 22
2279, 7, 5, 4, 2, 5, 23
2294, 1, 4, 2, 1, 4, 12
2309, 6, 5, 1, 2, 4, 18
2324, 3, 5, 2, 2, 3, 15
2339, 7, 4, 2, 2, 3, 18
2354, 4, 2, 6, 1, 4, 17
2369, 4, 8, 3, 0, 5, 20
2384, 8, 6, 3, 0, 7, 24
2399, 2, 4, 2, 5, 4, 17
2414, 5, 8, 2, 3, 6, 24
2429, 4, 5, 2, 2, 2, 15
2444, 10, 8, 1, 1, 8, 28
2459, 6, 2, 1, 1, 3, 13
2474, 1, 4, 1, 0, 3, 9
2489, 3, 3, 2, 1, 1, 10
2504, 2, 7, 1, 3, 5, 18
2519, 0, 2, 0, 3, 3, 8
2534, 3, 5, 1, 0, 3, 12
2549, 3, 2, 0, 0, 4, 9
2564, 1, 3, 0, 0, 1, 5
2579, 2, 5, 0, 0, 0, 7
2594, 1, 9, 4, 0, 1, 15
2609, 33, 39, 17, 15, 19, 123
2624, 4, 3, 1, 1, 1, 10
2639, 0, 3, 1, 0, 0, 4
2654, 1, 4, 1, 1, 1, 8
2669, 3, 3, 0, 1, 3, 10
2684, 6, 3, 1, 2, 2, 14
2699, 2, 1, 1, 1, 1, 6
2714, 0, 2, 1, 1, 0, 4
2729, 0, 3, 0, 0, 1, 4
2744, 4, 0, 1, 0, 0, 5
2759, 1, 2, 2, 0, 1, 6
2774, 3, 2, 0, 0, 0, 5
2789, 4, 1, 0, 1, 0, 6
2804, 1, 1, 1, 0, 3, 6
2819, 5, 4, 1, 0, 2, 12
2834, 0, 1, 0, 0, 1, 2
2849, 2, 3, 1, 1, 2, 9
2864, 3, 3, 1, 1, 1, 9
2879, 4, 2, 4, 0, 1, 11
2894, 1, 1, 1, 0, 1, 4
2909, 4, 2, 1, 0, 0, 7
2924, 5, 5, 2, 0, 2, 14
2939, 3, 5, 1, 0, 1, 10
2954, 2, 6, 0, 0, 2, 10
2969, 3, 1, 1, 0, 2, 7
2984, 5, 1, 1, 1, 1, 9
2999, 1, 2, 0, 1, 0, 4
3014, 2, 3, 2, 0, 2, 9
3029, 2, 1, 1, 0, 2, 6
3044, 1, 4, 0, 0, 2, 7
3059, 2, 3, 0, 0, 1, 6
3074, 3, 1, 1, 0, 0, 5
3089, 1, 5, 1, 0, 0, 7
3104, 1, 4, 0, 0, 2, 7
3119, 3, 0, 0, 1, 2, 6
3134, 1, 3, 0, 0, 1, 5
3149, 3, 1, 0, 1, 1, 6
3164, 1, 2, 1, 0, 2, 6
3179, 0, 5, 0, 1, 0, 6
3194, 4, 6, 1, 0, 3, 14
3209, 5, 0, 1, 0, 2, 8
3224, 5, 1, 1, 0, 0, 7
3239, 0, 4, 0, 0, 0, 4
3254, 1, 0, 0, 0, 5, 6
3269, 0, 6, 2, 0, 2, 10
3284, 3, 3, 1, 0, 0, 7
3299, 2, 2, 2, 0, 1, 7
3314, 2, 1, 1, 0, 0, 4
3329, 2, 5, 0, 0, 2, 9
3344, 6, 2, 0, 1, 0, 9
3359, 4, 2, 0, 0, 0, 6
3374, 1, 2, 0, 0, 2, 5
3389, 1, 0, 1, 0, 0, 2
3404, 3, 1, 0, 0, 3, 7
3419, 2, 0, 0, 0, 0, 2
3434, 2, 3, 1, 0, 2, 8
3449, 2, 1, 1, 0, 2, 6
3464, 1, 3, 0, 0, 1, 5
3479, 2, 5, 1, 1, 1, 10
3494, 4, 1, 0, 0, 3, 8
3509, 2, 1, 0, 0, 0, 3
3524, 2, 1, 1, 0, 3, 7
3539, 0, 1, 2, 0, 2, 5
3554, 5, 3, 1, 0, 1, 10
3569, 2, 2, 1, 0, 0, 5
3584, 5, 2, 0, 0, 3, 10
3599, 4, 2, 0, 0, 2, 8
3614, 3, 3, 0, 0, 0, 6
3629, 5, 4, 1, 0, 2, 12
3644, 2, 1, 0, 0, 2, 5
3659, 6, 2, 0, 1, 5, 14
3674, 4, 2, 4, 0, 2, 12
3689, 4, 5, 1, 0, 3, 13
3704, 1, 3, 0, 0, 3, 7
3719, 6, 3, 1, 0, 0, 10
3734, 3, 1, 0, 1, 2, 7
3749, 4, 2, 1, 0, 0, 7
3764, 6, 4, 2, 0, 3, 15
3779, 2, 4, 0, 0, 1, 7
3794, 2, 4, 1, 0, 0, 7
3809, 3, 2, 1, 0, 2, 8
3824, 4, 0, 0, 0, 1, 5
3839, 2, 2, 1, 1, 2, 8
3854, 3, 0, 0, 0, 1, 4
3869, 5, 3, 0, 0, 2, 10
3884, 1, 5, 2, 0, 3, 11
3899, 1, 1, 1, 0, 0, 3
3914, 7, 1, 2, 0, 2, 12
3929, 3, 3, 1, 0, 3, 10
3944, 2, 0, 1, 0, 3, 6
3959, 4, 0, 3, 1, 1, 9
3974, 3, 3, 0, 0, 1, 7
3989, 6, 5, 1, 0, 1, 13
4004, 4, 5, 0, 0, 0, 9
4019, 6, 6, 1, 1, 1, 15
4034, 2, 3, 0, 0, 5, 10
4049, 3, 7, 1, 1, 5, 17
4064, 1, 2, 4, 0, 2, 9
4079, 2, 3, 1, 0, 0, 6
4094, 0, 6, 1, 1, 1, 9
4109, 1, 5, 2, 0, 0, 8
4124, 2, 3, 0, 0, 1, 6
4139, 4, 3, 1, 1, 1, 10
4154, 2, 5, 3, 0, 5, 15
4169, 1, 5, 1, 0, 4, 11
4184, 3, 5, 1, 0, 4, 13
4199, 4, 7, 0, 0, 1, 12
4214, 1, 6, 2, 0, 3, 12
4229, 7, 9, 1, 0, 2, 19
4244, 1, 4, 1, 2, 1, 9
4259, 2, 4, 3, 0, 3, 12
4274, 4, 8, 1, 0, 0, 13
4289, 3, 3, 1, 0, 1, 8
4304, 3, 7, 1, 0, 1, 12
4319, 7, 5, 1, 0, 5, 18
4334, 4, 6, 2, 1, 2, 15
4349, 3, 4, 2, 0, 2, 11
4364, 2, 6, 2, 1, 1, 12
4379, 8, 6, 2, 0, 3, 19
4394, 6, 7, 1, 1, 0, 15
4409, 5, 2, 1, 0, 3, 11
4424, 9, 8, 0, 0, 3, 20
4439, 5, 10, 1, 0, 7, 23
4454, 3, 10, 2, 0, 2, 17
4469, 5, 4, 2, 1, 0, 12
4484, 1, 6, 5, 0, 0, 12
4499, 3, 7, 1, 0, 1, 12
4514, 3, 3, 1, 0, 2, 9
4529, 6, 7, 3, 0, 2, 18
4544, 5, 6, 2, 0, 3, 16
4559, 6, 8, 3, 1, 5, 23
4574, 4, 13, 9, 0, 7, 33
4589, 3, 5, 3, 0, 2, 13
4604, 7, 11, 2, 0, 6, 26
4619, 4, 7, 7, 0, 3, 21
4634, 4, 8, 2, 0, 5, 19
4649, 6, 15, 3, 1, 3, 28
4664, 4, 12, 3, 1, 4, 24
4679, 5, 6, 4, 2, 4, 21
4694, 6, 16, 3, 0, 2, 27
4709, 8, 4, 1, 1, 0, 14
4724, 5, 15, 5, 0, 3, 28
4739, 9, 18, 3, 0, 6, 36
4754, 4, 24, 4, 0, 3, 35
4769, 10, 14, 3, 0, 5, 32
4784, 4, 10, 4, 0, 7, 25
4799, 7, 6, 4, 1, 2, 20
4814, 6, 16, 7, 1, 5, 35
4829, 5, 16, 3, 0, 7, 31
4844, 12, 17, 4, 0, 8, 41
4859, 10, 18, 5, 0, 5, 38
4874, 10, 14, 2, 1, 2, 29
4889, 9, 15, 7, 1, 3, 35
4904, 9, 24, 5, 1, 7, 46
4919, 9, 21, 3, 2, 10, 45
4934, 11, 28, 11, 0, 3, 53
4949, 15, 23, 9, 1, 7, 55
4964, 14, 35, 6, 0, 7, 62
4979, 12, 17, 5, 1, 12, 47
4994, 26, 40, 11, 1, 9, 87
5009, 14, 36, 10, 0, 5, 65
5024, 13, 45, 13, 1, 10, 82
5039, 14, 49, 14, 3, 14, 94
5054, 23, 52, 10, 4, 16, 105
5069, 15, 57, 16, 3, 13, 104
5084, 25, 62, 18, 1, 20, 126
5099, 25, 67, 13, 4, 13, 122
5114, 38, 85, 21, 2, 16, 162
5129, 31, 74, 24, 3, 15, 147
5144, 45, 92, 20, 1, 24, 182
5159, 39, 96, 23, 2, 22, 182
5174, 34, 84, 24, 0, 26, 168
5189, 24, 70, 19, 0, 10, 123
5204, 5, 69, 13, 0, 2, 89
5219, 3, 37, 6, 0, 1, 47
5234, 1, 19, 4, 0, 2, 26
5249, 2, 0, 1, 0, 2, 5
5264, 1, 1, 0, 0, 2, 4
5279, 0, 1, 0, 0, 1, 2
5294, 0, 0, 0, 0, 2, 2
5309, 0, 1, 0, 0, 1, 2
5324, 0, 0, 0, 0, 0, 0
